||||||||||||||||||||||||||||||||||||
||        ||||||||||||     C||||||||
|| |||||| ||||||||M||| |||||||||||||
|| |||||| |||||||| ||| |||        ||
|| |||||| |||||||| ||| ||| |||||| ||
|| |               ||| ||| |||||| ||
|| ||||||||||||||| ||| ||| |||||| ||
|| ||||||C||| ||||          ||||| ||
|| |||||| ||| |||| |||||||||||||| ||
||C|||             |||||          ||
||||||||||||||||||||||||||||||||||||